■ ネットワーク
LAN→ローカルエリアネットワーク（会社内）
有線LAN→LANケーブルで接続されているネットワーク
無線LAN→LANケーブルなしのネットワーク
WAN→ワイドエリアネットワーク（会社と会社）
インターネット→コンピュータを接続しているネットワーク
■ ネットワーク構成
ノード→中継点、デバイス、端末
リンク→ノードをつなぐ線
トポロジ→各種端末機器がどのような形態で接続されるかを表す用語
バス型トポロジ→両端に終端装置を接続した1本の基幹回線にすべての端末を接続する形態
スター型トポロジ→1台の集線装置にすべての端末を接続する形態
メッシュ型トポロ→各端末を環状に接続する形態で、トークンパッシング方式伝送制御を基礎とするネットワークトポロジ
帯域→帯域とは、電波や電気信号の周波数の範囲
bps→bits per second の略で、1秒あたりに転送できるデータ数の単位
輻輳→インターネット回線や電話回線にアクセスが集中すること
コリジョン→イーサネットや無線LANで複数の端末が送信し、データが衝突する現象
ドメイン→インターネット上の住所のようなもの
ポート→機器の筐体などに設けられたケーブルやコネクタの差込口のこと
■ モデル
プロトコル→通信に関する規格
OSI参照モデル→国際標準化機構（ISO）という組織がコンピュータ等で行う通信方法を統一するために策定した規格のこと
ヘッダ→フレームやパケット、メッセージの先頭に付加される制御情報
カプセル化→オブジェクトの情報を隠蔽することによって、不整合を引き起こすような操作をできなくさせる仕組み
非カプセル化→本質的なデータ以外の情報を取り除く事
PDU→薄型のコンピュータなどを積み重ねて設置することができる専用の棚（サーバラック）に備え付ける電源タップ。データセンターなどで用いられる
MTU→ノードが隣接したネットワークへ、1回の通信で転送可能な最大のデータグラムサイズ 
フレーム→データリンク層を流れる“パケット”
パケット→すべてのプロトコル・スタックで，ネットワークを行き交うデータの単位として使われる一般的な用語
セグメント→断節、部分のことで、IT用語としてはネットワークを構成する個々のネットワーク環境や、コンピュータのメモリで一度にアクセスできる領域のこと
TCP/IPモデル→現在のインターネット通信およびイントラネット通信において最も利用されている通信プロトコル
■ 物理層
ビット→情報量の単位
ツイストペアケーブル→電線を2本対で撚り合わせたケーブル
UTP→シールド処理が施されていない、ペアの撚りケーブル
STP→円環上（ループ状）に形成されたレイヤー2ネットワークにおいて、データトラフィックが永続的に流れ続けることを防止するプロトコル
カテゴリー
コネクタ→電力や電気信号の流れをつなぐための電子部品
ストレートケーブル→内部に複数の芯線が通っている通信ケーブルのうち、各芯線が両端で同じ位置のピンに結線されているもの
クロスケーブル→パソコンとパソコンを機器を使用せず直接接続する場合に使用するケーブル
光ファイバケーブル→ガラスやプラスチックで構成された光信号を通すケーブル
ハブ→機器間をケーブルで結んで通信する際に、複数のケーブルを接続して相互に通信できるようにする集線装置、中継装置のこと
半二重通信
■ データリンク層
イーサネット→家庭・企業・データセンターなどで使用されるコンピューターネットワークにおいて、LANやWANを構成する有線ローカルエリアネットワークの主流な通信規格
ファストイーサネット→元来のイーサネットの速度10Mbpsに対し、公称100Mbpsの速度でトラフィックを伝えるいくつかのイーサネット規格の総称
ギガビットイーサネット→信速度が1Gbps（＝1000Mbps）のイーサネット規格の総称
イーサネットヘッダ→ネットワーク上を流れるデータの中身の一部で、イーサネットってお約束事で使う情報が書かれている部分のこと
トレーラ→相手のコンピュータが受信したときに、情報が伝送途中に壊れていないか確認するためのチェックコードのこと
CSMA/CD→初期イーサネットの制御方式
MACアドレス→Media Access Controlにおいて、ネットワークインタフェースを識別するために使用される識別子
スイッチ→コンピュータネットワークの集線装置の一種で、受信したデータの宛先を見て、接続された各機器への転送の可否を判断する機能を内蔵したもの
MACアドレステーブル→ネットワークスイッチなどが内部的に管理している情報で、どのポート（端子）にどのMACアドレスを持つ機器が接続されているかを記録したもの
フラッディング→ネットワーク機器のデータ転送方式の一種や、システムに許容量を超えるデータや処理要求が届き麻痺状態に陥る現象などをこのように呼ぶ
全二重通信→送信回線、受信回線をそれぞれ別に備えることで、送受を同時に行う事が可能です。 通信回線が２本以上必要なため、コストはかかりますが、伝送効率は高くなります
VLAN
タグVLAN
ポートベースVLAN
アクセスポート
トランクポート
DTP
デフォルトVLAN
ネイティブVLAN
ブロードキャストストーム
スパニングツリープロトコル
リンクアグリゲーション
EtherChannel